01100000000000000000000000002222222222222222222222222222-
01100000000000001111111000002222222222222222222222222222-
01100000000000001111111000002222222333333333333333333322-
01100000000000001100011000002222222333333333333333333322-
01111111111110001100011000002222222332222222222222223322-
01111111111110001100011000002222222332222222222222223322-
00000000000110001100011000002222222332222222222222223322-
00000000000110001100011000002222222332222222222222223322-
00000000000110001100011000002222222332222222222222223322-
00000000000110001100011000002222222332222222222222223322-
00000000000110001100011000002222222332233333333333333322-
00000000000110001100011000002222222332233333333333333322-
00000000000110001100011000002222222332233222222222222222-
00000000000110001100011000002222222332233222222222222222-
00001111111110001100011000002222222332233222222222222222-
00001111111110001100011000002222222332233222222222222222-
00001100000000001100011000002222222332233222222222233333-
00001100000000001100011000002222222332233222222222233333-
00001100000000001100011000002222222332233222222222233333-
00001111111111111100011000002222222332233222222222233222-
00001111111111111100011000002222222332233222222222233222-
00000000000000000000011111113333333332233333333333333222-
00000000000000000000011111113333333332233333333333333222-
00000000000000000000000000002222222222222222222222222222-
00000000000000000000000000002222222222222222222222222222